###########
#.      o.#
#o        #
#         #
#o   #. o #
#.  ###   #
#    #p   #
#         #
#        o#
#.o      .#
###########