#########
#po.    #
# oo.   #
# .     #
#       #
#     o.#
#########